{
  "1": "等级1",
  "2": "等级2",
  "3": "等级3",
  "4": "等级4",
  "5": "等级5",
  "6": "等级6",
  "7": "等级7",
  "8": "等级8（专精1）",
  "9": "等级9（专精2）",
  "10": "等级10（专精3）"
}